1176111611162226111611161116222611161116111622261116111611162226111611161116222611161116111622
1671165556111611161116555611161116111655561116111611165556111611161116555611161116111655561116
1117111611162226111611161116222611161116111622261116111611162226111611161116222611161116111622
1617165556111611161116555611161116111655561116111611165556111611161116555611161116111655561116
1117117711762226111611161116222611161116111622261116111611162226111611161116222611161116111622
1611775577111611161116555611161116111655561116111611165556111611161116555611161116111655561116
1116111611162226111611161116222611161116111622261116111611162226111611161116222611161116111622
1611165556111611161116555611161116111655561116111611165556111611161116555611161116111655561116
1116111611162226111611161116222611161116111622261116111611162226111611161116222611161116111622
1611165556111611161116555611161116111655561116111611165556111611161116555611161116111655561116
1116111611162226111611161116222611161116111622261116111611162226111611161116222611161116111622
1611165556111611161116555611161116111655561116111611165556111611161116555611161116111655561116
1116111611162226111611161116222611161116111622261116111611162226111611161116222611161116111622
1611165556111611161116555611161116111655561116111611165556111611161116555611161116111655561116
1116111611162226111611161116222611161116111622261116111611162226111611161116222611161116111622
1611165556111611161116555611161116111655561116111611165556111611161116555611161116111655561116
1116111611162226111611161116222611161116111622261116111611162226111611161116222611161116111622
1611165556111611161116555611161116111655561116111611165556111611161116555611161116111655561116
1116111611162226111611161116222611161116111622261116111611162226111611161116222611161116111622
1611165556111611161116555611161116111655561116111611165556111611161116555611161116111655561116
1116111611162226111611161116222611161116111622261116111611162226111611161116222611161116111622
1611165556111611161116555611161116111655561116111611165556111611161116555611161116111655561116
1116111611162226111611161116222611161116111622261116111611162226111611161116222611161116111622
1611165556111611161116555611161116111655561116111611165556111611161116555611161116111655561116
1116111611162226111611161116222611161116111622261116111611162226111611161116222611161116111622
1611165556111611161116555611161116111655561116111611165556111611161116555611161116111655561116
1116111611162226111611161116222611161116111622261116111611162226111611161116222611161116111622
3611165556111611161116555611161116111655561116111611165556111611161116555611161116111655561146
